11111111111111111
12150000000030001
10111131111111101
10000161100011101
10111111001001101
10111401011100101
10111100011110101
10111113100010101
10000010101000101
10111110101111101
10300000100030001
11111111111111111

