111111111111111111111111111
100000030001110001111000051
101110111101110101111013111
101610110100110101000010101
101010110110000103011100101
101000300110110111111101101
101101110110110000001000001
101101110110111111111011101
101100000000000000000001301
100010111111110110111101011
101110111111110110103101011
101000300001110110101101111
101110111100000300001100001
101110111101110111111101101
100002000000010100000101101
110110111111010101111101101
110110100000010000000001101
110110101111011111011111101
110110101101010011010030001
110110100001011011011111101
110110111111011011000000001
110110000001011011111110101
110111111101011000000000101
110111111100011011111111101
110300000001111011111111101
111111111103000000000030001
111111111111111111111111111